{
"data": {
    "0": {
      "0": "U",
      "1": "U",
      "2": "U",
      "3": "U",
      "4": "U",
      "5": "D",
      "6": "D",
      "7": "D",
      "8": "U",
      "9": "U",
      "10": "D",
      "11": "D",
      "12": "D",
      "13": "U"
    },
    "1": {
      "0": "U",
      "1": "U",
      "2": "U",
      "3": "U",
      "4": "U",
      "5": "D",
      "6": "D",
      "7": "D",
      "8": "U",
      "9": "U",
      "10": "D",
      "11": "D",
      "12": "D",
      "13": "U"
    },
    "2": {
      "0": "U",
      "1": "U",
      "2": "U",
      "3": "U",
      "4": "U",
      "5": "D",
      "6": "D",
      "7": "D",
      "8": "U",
      "9": "U",
      "10": "D",
      "11": "D",
      "12": "D",
      "13": "U"
    },
    "3": {
      "0": "U",
      "1": "U",
      "2": "U",
      "3": "U",
      "4": "U",
      "5": "D",
      "6": "D",
      "7": "D",
      "8": "U",
      "9": "U",
      "10": "D",
      "11": "D",
      "12": "D",
      "13": "U"
    },
    "4": {
      "0": "U",
      "1": "U",
      "2": "U",
      "3": "U",
      "4": "U",
      "5": "D",
      "6": "D",
      "7": "D",
      "8": "U",
      "9": "U",
      "10": "D",
      "11": "D",
      "12": "D",
      "13": "U"
    },
    "5": {
      "0": "U",
      "1": "U",
      "2": "U",
      "3": "U",
      "4": "U",
      "5": "D",
      "6": "D",
      "7": "D",
      "8": "U",
      "9": "U",
      "10": "D",
      "11": "D",
      "12": "D",
      "13": "U"
    },
    "6": {
      "0": "U",
      "1": "U",
      "2": "F",
      "3": "U",
      "4": "U",
      "5": "D",
      "6": "D",
      "7": "D",
      "8": "U",
      "9": "U",
      "10": "D",
      "11": "D",
      "12": "D",
      "13": "U"
    },
    "7": {
      "0": "U",
      "1": "U",
      "2": "U",
      "3": "U",
      "4": "U",
      "5": "D",
      "6": "D",
      "7": "D",
      "8": "U",
      "9": "U",
      "10": "D",
      "11": "D",
      "12": "D",
      "13": "U"
    },
    "8": {
      "0": "U",
      "1": "U",
      "2": "U",
      "3": "U",
      "4": "X",
      "5": "D",
      "6": "D",
      "7": "X",
      "8": "U",
      "9": "U",
      "10": "D",
      "11": "D",
      "12": "D",
      "13": "U"
    },
    "9": {
      "0": "U",
      "1": "U",
      "2": "U",
      "3": "U",
      "4": "X",
      "5": "D",
      "6": "D",
      "7": "X",
      "8": "U",
      "9": "X",
      "10": "D",
      "11": "D",
      "12": "D",
      "13": "U"
    },
    "10": {
      "0": "U",
      "1": "U",
      "2": "U",
      "3": "U",
      "4": "X",
      "5": "D",
      "6": "D",
      "7": "D",
      "8": "U",
      "9": "U",
      "10": "D",
      "11": "D",
      "12": "D",
      "13": "U"
    },
    "11": {
      "0": "U",
      "1": "U",
      "2": "U",
      "3": "U",
      "4": "U",
      "5": "D",
      "6": "D",
      "7": "D",
      "8": "U",
      "9": "U",
      "10": "D",
      "11": "D",
      "12": "D",
      "13": "U"
    },
    "12": {
      "0": "U",
      "1": "X",
      "2": "X",
      "3": "U",
      "4": "U",
      "5": "X",
      "6": "X",
      "7": "D",
      "8": "U",
      "9": "U",
      "10": "D",
      "11": "D",
      "12": "D",
      "13": "U"
    },
    "13": {
      "0": "U",
      "1": "U",
      "2": "U",
      "3": "U",
      "4": "U",
      "5": "D",
      "6": "D",
      "7": "D",
      "8": "U",
      "9": "U",
      "10": "D",
      "11": "D",
      "12": "D",
      "13": "U"
    }
  }
}